11111111122222222222221122222111222222222211122222222222222
22211222222222222222221122222211222111222111222222222222222
22211222222222222222221122222211222111122111222222222222222
22211211111122211111221122111211221111122111211111122221111
22211111221122211211221121112221121111122111111221122111222
22211222222112112221121111122221121121121112222222112112222
22211222222112112221121111222221121121111112222222112112222
22211221111112112221121111222221111121111112221111112112222
22211211122112112221121111122222111122211122211122112112222
22211211222112112221121121122222111222211122211222112112222
22211211221112112221121122112222111222211122211221112112222
22211211111112112221121122111122111222211122211111112112222