00000000333300000000000000
00000000333300000000000000
00000000330000005555550000
55003300330000000000550000
55003300000033000000000000
55003300000033000000000000
33003333330033330044440044
33003333330033330044440044
33000000330000000044000000
00000000000000000044000000
00000000444400444444003333
00003300444400444444003333
33330000443300333000000000
33330000443300333000000000
00000000440000000000055000
00000000440000000000055000
44444400440055003300050000
44444400440055003300050000
00000000000000000000053333
00000033330000000000053333
00000000333333333300000000
00000000330000003333000000
33333300000000000033330000
33330000000333300000330000
33000000000300300000000000
00000000000300300000000000