0000000033330000000000000000000000000000000000000000
0000000033330000000000000000000000000000000000000000
0000000033000000555555000000000000000000000000000000
5500330033000000000055000000000000000000000000000000
5500330000003300000000000000000000000000000000000000
5500330000003300000000000000000000000000000000000000
3300333333003333004444004400000000000000000000000000
3300333333003333004444004400000000000000000000000000
3300000033000000004400000000000000000000000000000000
0000000000000000004400000000000000000000000000000000
0000000044440044444400333300000000000000000000000000
0000330044440044444400333300000000000000000000000000
3333000044330033300000000000000000000000000000000000
3333000044330033300000000000000000000000000000000000
0000000044000000000005500000000000000000000000000000
0000000044000000000005500000000000000000000000000000
4444440044005500330005000000000000000000000000000000
4444440044005500330005000000000000000000000000000000
0000000000000000000005333300000000000000000000000000
0000003333000000000005333300000000000000000000000000
0000000033333333330000000000000000000000000000000000
0000000033000000333300000000000000000000000000000000
3333330000000000003333000000000000000000000000000000
3333000000033330000033000000000000000000000000000000
3300000000030030000000000000000000000000000000000000
0000000000030030000000000000000000000000000000000000